20
20
-X------------------
-X---X-----XXX------
-X---XXXX--X-X--X---
----X--XX--X-X--XXXX
XXXX-----X---X------
XX---X---X-X-X--XXXX
XXX---X--------XX---
XX-----XXXXXXXX-----
------X----------X--
---XXX----XXXX---X--
---X-----XXXXXX---X-
-----X--XXX-------X-
XXXXX-X-XXXXXXXXX---
--XXXX----XX--XXX-X-
------XX-----------X
-XX-X-XX-XXXXXXXXXX-
---X-----X----------
-XX-XXXXX-----XXXX--
-----------XXX-----X
XXXXXXXXXXXX----XX--